xxxxxxxxxxxxxxxxxxxxxxxxxxxxxxxxxxxxxxxxxxxxxxxxxxxxxxxxxxxxxxxxxxxxxxxxxxxxxxxxxxxxxx
xxxxxxxxxxxxxxxxxxxxxxxxxxxxxxxxxxxxxxxxxxxxxxxxxxxxxxxxxxxxxxxxxxxxxxxxxxxxxxxxxxxxxx
xxxxxxxxxxxxxxxxxxxxxxxxxxxxxxxxxxxxxxxxxxxxxxxxxxxxxxbbbbbbbbbbbbxxxxxxxxxxxxxxxxxxxx
xxx                                               dd                               xxx
xxx                                                                                xxx
xxx          w                                                                     xxx
xxx                                                                                xxx
xxx                                                                                xxx
xxx                                                                                xxx
xxx                                   w                                            xxx
xxx                                                                                xxx
xxx                                                                                xxx
xxx  p           uu                                                                xxx
xxxxxxxxxxxxxxxxxxxxxxxxaaaaaaaaaaaaaxxxxxxxxxxxxxxxxxxxxxxxxxxxxxxxxxxxxxxxx      xxx
xxxxxxxxxxxxxxxxxxxxxxxxxxxxxxxxxxxxxxxxxxxxxxxxxxxxxxxxxxxxxxxxxxxxxxxxxxxxx      xxx
xxxxxxxxxxxxxxxxxxxxxxxxxxxxxxxxxxxxxxxxxxxxxxxxxxxxxxxxxxxxxxxxxxxxxxxxxxxxx      xxx
xxx       dd         y         E       y                                           xxx
xxx                                                                                xxx
xxx                                                                                xxx
xxx                                                                                xxx
xxx                                                                                xxx
xxx                                                      w                         xxx
xxx                                                                                xxx
xxx                                                                                xxx
xxx                                                                                xxx
xxx     y             C   y         y  uu         C              C        y        xxx
xxx      xxxxxxxxxxxxxxxxxxaaaaaaaaaxxxxxxxxxxxxxxxxxxxxxxxxxxxxxxxxxxxxxxxxxxxxxxxxxx
xxx      xxxxxxxxxxxxxxxxxxxxxxxxxxxxxxxxxxxxxxxxxxxxxxxxxxxxxxxxxxxxxxxxxxxxxxxxxxxxx
xxx      xxxxxxxxxxxxxxxxxxxxxxxxxxxxxxxxxxxxxxxxxxxxxxxxxxxxxxxxxxxxxxxxxxxxxxxxxxxxx
xxx                                y     E      y            dd                    xxx
xxx                                                                                xxx
xxx                                                                                xxx
xxx                                                      w                         xxx
xxx                                                                                xxx
xxx                                                                                xxx
xxx                w                                                               xxx
xxx                                                                                xxx
xxx                                                                                xxx
xxx     y       C       y   uu                                            f        xxx
xxxxxxxxxxxxxxxxxxxxxxxxxxxxxxxxxxxxxxaaaaaaaaaaaaaaxxxxxxxxxxxxxxxxxxxxxxxxxxxxxxxxxx
xxxxxxxxxxxxxxxxxxxxxxxxxxxxxxxxxxxxxxxxxxxxxxxxxxxxxxxxxxxxxxxxxxxxxxxxxxxxxxxxxxxxxx
xxxxxxxxxxxxxxxxxxxxxxxxxxxxxxxxxxxxxxxxxxxxxxxxxxxxxxxxxxxxxxxxxxxxxxxxxxxxxxxxxxxxxx